NO ./images/n.png
SO ./images/s.png
WE ./images/w.png
EA ./images/e.png
F 240,233,133
C 2215,0,0

1111111
1000001
100N001
1000001
1111111
