NO ./images/newyonko.png
SO ./images/yonkous.png
WE ./images/shichibukais.png
EA ./images/wanted.png
F 220,100,0
C 225,30,0

11111111111111111
11100000000000111
11100000000000111
11100000N000001111
11100000000000111
11100000000000111
11111111111111111


