SO ./images/s.png
WE ./images/w.png
F 240,233,133
EA ./images/e.png
C 225,0,0
NO ./images/n.png

1111111
1001001
100N001
1000001
1111111
